2 2 2 2 2 2 2 2 2 2 2 2 2 2 2 2 2 2 2 2 2 2 2 2 2 2 2 2 2 2 2 2 2 2 2 2 2 2 2 2 2 2 2 2 2 2 2 2 2 2 2 2 2 2 2 2 2 2 2 2 2 2
2 2 2 2 2 2 2 2 2 2 2 2 2 2 2 2 2 2 2 2 2 2 2 2 2 2 2 2 2 2 2 2 2 2 2 2 2 2 2 2 2 2 2 2 2 2 2 2 2 2 2 2 2 2 2 2 2 2 2 2 2 2
2 2 2 2 2 2 2 2 2 2 2 2 2 2 2 2 2 2 2 2 2 2 2 2 2 2 2 2 2 2 2 2 2 2 2 2 2 2 2 2 2 2 2 2 2 2 2 2 2 2 2 2 2 2 2 2 2 2 2 2 2 2
2 2 2 2 2 2 2 2 2 2 2 2 2 2 2 2 2 2 2 2 2 2 2 2 2 2 2 2 2 2 2 2 2 2 2 2 2 2 2 2 2 2 2 2 2 2 2 2 2 2 2 2 2 2 2 2 2 2 2 2 2 2
2 2 2 2 2 2 2 2 2 2 2 2 2 2 2 2 2 2 2 2 2 2 2 2 2 2 2 2 2 2 2 2 2 2 2 2 2 2 2 2 2 2 2 2 2 2 2 2 2 2 2 2 2 2 2 2 2 2 2 2 2 2
2 2 2 2 2 2 2 2 2 2 2 2 2 2 2 2 2 2 2 2 2 2 2 2 2 2 2 2 2 2 2 2 2 2 2 2 2 2 2 2 2 2 2 2 2 2 2 2 2 2 2 2 2 2 2 2 2 2 2 2 2 2
2 2 2 2 2 2 2 2 2 2 2 2 2 2 2 2 2 2 2 2 2 2 2 2 2 2 2 2 2 2 2 2 2 2 2 2 2 2 2 2 2 2 2 2 2 2 2 2 2 2 2 2 2 2 2 2 2 2 2 2 2 2
2 2 2 2 2 2 2 2 2 2 2 2 2 2 2 2 2 2 2 2 2 2 2 2 2 2 2 2 2 2 2 2 2 2 2 2 2 2 2 2 2 2 2 2 2 2 2 2 2 2 2 2 2 2 2 2 2 2 2 2 2 2
2 2 2 2 2 2 2 2 4 4 4 4 4 4 4 4 4 4 4 4 4 4 4 0 0 0 0 4 4 4 4 4 4 4 4 4 4 4 4 4 4 0 0 0 0 0 0 0 5 5 5 5 5 5 2 2 2 2 2 2 2 2
2 2 2 2 2 2 2 2 4 4 4 4 4 4 4 4 4 4 4 4 4 4 4 0 0 0 0 4 4 4 4 4 4 4 4 4 4 4 4 4 4 0 0 0 0 0 0 0 5 5 5 5 5 5 2 2 2 2 2 2 2 2
2 2 2 2 2 2 2 2 4 4 0 0 0 0 0 0 0 0 0 0 0 4 4 0 0 0 0 0 0 0 0 0 0 0 5 5 5 0 0 4 4 0 0 0 0 0 0 0 5 5 5 5 5 5 2 2 2 2 2 2 2 2
2 2 2 2 2 2 2 2 4 4 0 0 0 0 0 0 0 0 0 0 0 4 4 0 0 0 0 0 0 0 0 0 0 0 5 5 5 0 0 4 4 0 0 0 0 0 0 0 5 5 5 5 5 5 2 2 2 2 2 2 2 2
2 2 2 2 2 2 2 2 4 4 0 0 0 0 0 0 0 0 0 0 0 4 4 0 0 0 0 0 0 0 0 0 0 0 5 5 5 0 0 4 4 0 0 0 0 0 0 0 5 5 5 5 5 5 2 2 2 2 2 2 2 2
2 2 2 2 2 2 2 2 4 4 0 0 0 0 0 0 0 0 0 0 0 4 4 0 0 0 0 0 0 0 0 0 0 0 5 5 5 0 0 4 4 0 0 0 0 0 0 0 5 5 5 5 5 5 2 2 2 2 2 2 2 2
2 2 2 2 2 2 2 2 4 4 0 0 0 0 0 0 0 0 0 0 0 4 4 0 0 0 0 0 0 0 0 0 0 0 5 5 5 0 0 4 4 0 0 0 0 0 0 0 5 5 5 5 5 5 2 2 2 2 2 2 2 2
2 2 2 2 2 2 2 2 4 4 0 0 0 0 3 3 3 3 3 3 3 4 4 0 0 0 0 0 0 0 0 0 0 0 5 5 5 0 0 4 4 0 0 0 0 0 0 0 5 5 5 5 5 5 2 2 2 2 2 2 2 2
2 2 2 2 2 2 2 2 4 4 0 0 0 0 3 3 3 3 3 3 3 4 4 0 0 0 0 0 0 0 0 0 0 0 5 5 5 0 0 4 4 0 0 0 0 0 0 0 5 5 5 5 5 5 2 2 2 2 2 2 2 2
2 2 2 2 2 2 2 2 4 4 0 0 0 0 3 3 3 3 3 3 3 4 4 4 4 4 4 4 4 4 4 4 0 0 5 5 5 0 0 4 4 0 0 0 0 0 0 0 5 5 5 5 5 5 2 2 2 2 2 2 2 2
2 2 2 2 2 2 2 2 4 4 0 0 0 0 3 3 3 3 3 3 3 4 4 4 4 4 4 4 4 4 4 4 0 0 5 5 5 0 0 4 4 0 0 0 0 0 0 0 5 5 5 5 5 5 2 2 2 2 2 2 2 2
2 2 2 2 2 2 2 2 4 4 0 0 0 0 3 3 3 3 3 3 3 4 4 5 5 5 5 5 5 5 4 4 0 0 5 5 5 0 0 4 4 0 0 0 0 0 0 0 5 5 5 5 5 5 2 2 2 2 2 2 2 2
2 2 2 2 2 2 2 2 0 0 0 0 0 0 3 3 3 3 3 3 3 4 4 5 5 5 5 5 5 5 4 4 0 0 5 5 5 0 0 4 4 0 0 0 0 0 0 0 5 5 5 5 5 5 2 2 2 2 2 2 2 2
2 2 2 2 2 2 2 2 0 0 0 0 0 0 3 3 3 3 3 3 3 4 4 5 5 5 5 5 5 5 5 5 0 0 5 5 5 0 0 4 4 0 0 0 0 0 0 0 4 4 4 4 4 4 2 2 2 2 2 2 2 2
2 2 2 2 2 2 2 2 4 4 4 4 4 4 4 4 4 4 4 4 4 4 4 5 5 5 5 5 5 5 4 4 0 0 5 5 5 0 0 4 4 0 0 0 0 0 0 0 4 4 4 4 4 4 2 2 2 2 2 2 2 2
2 2 2 2 2 2 2 2 4 4 4 4 4 4 4 4 4 4 4 4 4 4 4 5 5 5 5 5 5 5 4 4 0 0 5 5 5 0 0 4 4 0 0 0 0 0 0 0 4 4 2 2 2 2 2 2 2 2 2 2 2 2
2 2 2 2 2 2 2 2 4 4 8 8 5 5 5 5 5 5 5 5 5 4 4 5 5 5 5 5 5 5 4 4 0 0 5 5 5 0 0 4 4 0 0 0 0 0 0 0 4 4 2 2 2 2 2 2 2 2 2 2 2 2
2 2 2 2 2 2 2 2 4 4 8 8 5 5 5 5 5 5 5 5 5 4 4 5 5 5 5 5 5 5 4 4 0 0 5 5 5 0 0 4 4 0 0 0 0 0 0 0 4 4 2 2 2 2 2 2 2 2 2 2 2 2
2 2 2 2 2 2 2 2 4 4 8 8 5 5 5 5 5 5 5 5 5 4 4 5 5 5 5 5 5 5 4 4 0 0 5 5 5 0 0 4 4 4 4 4 4 4 4 4 4 4 2 2 2 2 2 2 2 2 2 2 2 2
2 2 2 2 2 2 2 2 4 4 8 8 5 5 5 5 5 5 5 5 5 4 4 5 5 5 5 5 5 5 4 4 0 0 5 5 5 0 0 4 4 4 4 4 4 4 4 4 4 4 2 2 2 2 2 2 2 2 2 2 2 2
2 2 2 2 2 2 2 2 4 4 8 8 4 4 4 4 4 4 4 4 4 4 4 5 5 5 5 5 5 5 4 4 0 0 5 5 5 0 0 0 0 0 0 0 0 0 0 0 4 4 2 2 2 2 2 2 2 2 2 2 2 2
2 2 2 2 2 2 2 2 4 4 8 8 4 4 4 4 4 4 4 4 4 4 4 5 5 5 5 5 5 5 4 4 0 0 5 5 5 0 0 0 0 0 0 0 0 0 0 0 4 4 2 2 2 2 2 2 2 2 2 2 2 2
2 2 2 2 2 2 2 2 4 4 8 8 4 4 8 8 5 5 5 4 4 5 5 5 5 5 5 5 5 5 4 4 0 0 5 5 5 0 0 0 0 0 0 0 0 0 0 0 4 4 2 2 2 2 2 2 2 2 2 2 2 2
2 2 2 2 2 2 2 2 4 4 8 8 4 4 8 8 5 5 5 4 4 5 5 5 5 5 5 5 5 5 4 4 0 0 5 5 5 0 0 0 0 0 0 0 0 0 0 0 4 4 2 2 2 2 2 2 2 2 2 2 2 2
2 2 2 2 2 2 2 2 4 4 8 8 4 4 8 8 5 5 5 4 4 5 5 5 5 5 5 5 5 5 4 4 0 0 5 5 5 0 0 0 0 0 0 0 0 0 0 0 4 4 2 2 2 2 2 2 2 2 2 2 2 2
2 2 2 2 2 2 2 2 4 4 8 8 4 4 8 8 5 5 5 4 4 4 4 4 4 4 4 4 4 4 4 4 4 4 4 4 4 4 4 4 4 4 4 4 4 4 4 4 4 4 4 4 4 4 2 2 2 2 2 2 2 2
2 2 2 2 2 2 2 2 4 4 8 8 4 4 8 8 5 5 5 4 4 4 4 4 4 4 4 4 4 4 4 4 4 4 4 4 4 4 4 4 4 4 4 4 4 4 4 4 4 4 4 4 4 4 2 2 2 2 2 2 2 2
2 2 2 2 2 2 2 2 4 4 8 8 4 4 8 8 5 5 5 5 5 5 5 5 5 5 5 5 4 4 6 6 6 6 0 0 0 0 5 5 5 5 4 4 0 0 0 0 0 0 0 0 4 4 2 2 2 2 2 2 2 2
2 2 2 2 2 2 2 2 4 4 8 8 4 4 8 8 5 5 5 5 5 5 5 5 5 5 5 5 4 4 6 6 6 6 0 0 0 0 5 5 5 5 4 4 0 0 0 0 0 0 0 0 4 4 2 2 2 2 2 2 2 2
2 2 2 2 2 2 2 2 4 4 8 8 4 4 8 8 5 5 5 5 5 5 5 5 5 5 5 5 4 4 6 6 6 6 0 0 0 0 5 5 5 5 4 4 0 0 0 0 2 2 2 2 4 4 2 2 2 2 2 2 2 2
2 2 2 2 2 2 2 2 4 4 8 8 4 4 8 8 5 5 5 5 5 5 5 5 5 5 5 5 4 4 6 6 6 6 0 0 0 5 5 5 5 5 4 4 0 0 0 0 2 2 2 2 4 4 2 2 2 2 2 2 2 2
2 2 2 2 2 2 2 2 4 4 8 8 4 4 8 8 5 5 5 5 5 5 5 5 5 5 5 5 4 4 6 6 6 6 0 0 0 5 5 5 5 5 4 4 0 0 0 0 2 2 2 2 4 4 2 2 2 2 2 2 2 2
2 2 2 2 2 2 2 2 4 4 8 8 4 4 4 4 4 4 4 4 4 4 4 4 4 4 4 4 4 4 6 6 6 6 0 0 0 5 5 5 5 5 4 4 0 0 0 0 2 2 2 2 4 4 2 2 2 2 2 2 2 2
2 2 2 2 2 2 2 2 4 4 8 8 4 4 4 4 4 4 4 4 4 4 4 4 4 4 4 4 4 4 6 6 6 6 0 0 0 5 5 5 5 5 4 4 0 0 0 0 2 2 2 2 4 4 2 2 2 2 2 2 2 2
2 2 2 2 2 2 2 2 4 4 2 2 2 2 4 4 6 6 6 6 6 6 6 6 6 6 6 6 6 6 6 6 6 6 0 0 0 5 5 5 5 5 4 4 0 0 0 0 2 2 2 2 4 4 2 2 2 2 2 2 2 2
2 2 2 2 2 2 2 2 4 4 2 2 2 2 4 4 6 6 6 6 6 6 6 6 6 6 6 6 6 6 6 6 6 6 0 0 0 5 5 5 5 5 4 4 0 0 0 0 2 2 2 2 4 4 2 2 2 2 2 2 2 2
2 2 2 2 2 2 2 2 4 4 2 2 2 2 4 4 6 6 6 6 6 6 6 6 6 6 6 6 6 6 6 6 6 6 0 0 0 5 5 5 5 5 4 4 0 0 0 0 2 2 2 2 4 4 2 2 2 2 2 2 2 2
2 2 2 2 2 2 2 2 4 4 2 2 2 2 4 4 0 0 0 0 0 0 0 0 0 0 0 0 0 0 0 0 0 0 0 0 0 5 5 5 5 5 4 4 0 0 0 0 2 2 2 2 4 4 2 2 2 2 2 2 2 2
2 2 2 2 2 2 2 2 4 4 2 2 2 2 4 4 5 5 5 5 5 5 5 5 5 5 5 5 5 5 5 5 5 5 5 5 5 5 5 5 5 5 4 4 0 0 0 0 0 0 0 0 4 4 2 2 2 2 2 2 2 2
2 2 2 2 2 2 2 2 4 4 2 2 2 2 4 4 5 5 5 5 5 5 5 5 5 5 5 5 5 5 5 5 5 5 5 5 5 5 5 5 5 5 4 4 0 0 0 0 0 0 0 0 4 4 2 2 2 2 2 2 2 2
2 2 2 2 2 2 2 2 4 4 2 2 2 2 4 4 4 4 4 4 4 4 4 4 4 4 4 4 4 4 4 4 4 4 4 4 4 4 4 4 4 4 4 4 4 4 4 4 4 4 4 4 4 4 2 2 2 2 2 2 2 2
2 2 2 2 2 2 2 2 4 4 2 2 2 2 4 4 4 4 4 4 4 4 4 4 4 4 4 4 4 4 4 4 4 4 4 4 4 4 4 4 4 4 4 4 4 4 4 4 4 4 4 4 4 4 2 2 2 2 2 2 2 2
2 2 2 2 2 2 2 2 4 4 2 2 2 2 4 4 5 5 5 5 5 5 5 5 5 5 5 5 5 5 5 5 5 5 5 5 5 5 5 5 5 5 5 5 5 5 5 5 5 5 4 4 0 5 2 2 2 2 2 2 2 2
2 2 2 2 2 2 2 2 4 4 2 2 2 2 4 4 5 5 5 5 5 5 5 5 5 5 5 5 5 5 5 5 5 5 5 5 5 5 5 5 5 5 5 5 5 5 5 5 5 5 4 4 5 5 2 2 2 2 2 2 2 2
2 2 2 2 2 2 2 2 4 4 4 4 4 4 4 4 5 5 5 5 5 5 5 5 5 5 5 5 5 5 5 5 5 5 5 5 5 5 5 5 5 5 5 5 5 5 5 5 5 5 4 4 5 5 2 2 2 2 2 2 2 2
2 2 2 2 2 2 2 2 4 4 4 4 4 4 4 4 5 5 5 5 5 5 5 5 5 5 5 5 5 5 5 5 5 5 5 5 5 5 5 5 5 5 5 5 5 5 5 5 5 5 4 4 5 5 2 2 2 2 2 2 2 2
2 2 2 2 2 2 2 2 2 2 2 2 2 2 2 2 2 2 2 2 2 2 2 2 2 2 2 2 2 2 2 2 2 2 2 2 2 2 2 2 2 2 2 2 2 2 2 2 2 2 2 2 2 2 2 2 2 2 2 2 2 2
2 2 2 2 2 2 2 2 2 2 2 2 2 2 2 2 2 2 2 2 2 2 2 2 2 2 2 2 2 2 2 2 2 2 2 2 2 2 2 2 2 2 2 2 2 2 2 2 2 2 2 2 2 2 2 2 2 2 2 2 2 2
2 2 2 2 2 2 2 2 2 2 2 2 2 2 2 2 2 2 2 2 2 2 2 2 2 2 2 2 2 2 2 2 2 2 2 2 2 2 2 2 2 2 2 2 2 2 2 2 2 2 2 2 2 2 2 2 2 2 2 2 2 2
2 2 2 2 2 2 2 2 2 2 2 2 2 2 2 2 2 2 2 2 2 2 2 2 2 2 2 2 2 2 2 2 2 2 2 2 2 2 2 2 2 2 2 2 2 2 2 2 2 2 2 2 2 2 2 2 2 2 2 2 2 2
2 2 2 2 2 2 2 2 2 2 2 2 2 2 2 2 2 2 2 2 2 2 2 2 2 2 2 2 2 2 2 2 2 2 2 2 2 2 2 2 2 2 2 2 2 2 2 2 2 2 2 2 2 2 2 2 2 2 2 2 2 2
2 2 2 2 2 2 2 2 2 2 2 2 2 2 2 2 2 2 2 2 2 2 2 2 2 2 2 2 2 2 2 2 2 2 2 2 2 2 2 2 2 2 2 2 2 2 2 2 2 2 2 2 2 2 2 2 2 2 2 2 2 2
2 2 2 2 2 2 2 2 2 2 2 2 2 2 2 2 2 2 2 2 2 2 2 2 2 2 2 2 2 2 2 2 2 2 2 2 2 2 2 2 2 2 2 2 2 2 2 2 2 2 2 2 2 2 2 2 2 2 2 2 2 2
2 2 2 2 2 2 2 2 2 2 2 2 2 2 2 2 2 2 2 2 2 2 2 2 2 2 2 2 2 2 2 2 2 2 2 2 2 2 2 2 2 2 2 2 2 2 2 2 2 2 2 2 2 2 2 2 2 2 2 2 2 2